S  X                
 X XXXXXXXXXXXXXX X 
 X X X          X X 
 X X X XXXXXXXXXXXX 
 X     X            
 XXXXXXXXXXXXXXXXXX 
 X      X         X 
 X   X    X X X   X 
 X   X  X X X XXX X 
 X  XXXXX   X X   X 
 X      XXX X X XXX 
 XXXXXX X   X X   X 
      X X XXX XXX X 
XXXXX   X   X  X  X 
X X XXX X   XXXXX X 
  X X   X XXX       
 XX X X X   XXXXXXX 
      XXX         X 
XXXXXXXXX XXXXXXXXXX
                   E